00000000
00000000
00000000
00000000
36632660
32318830
32262270
67682680
83287830
33616760
66636330
36163370
73363760
62272360
62223370
37323270
32283330
87663620
36323320
33337830
22276110
36338660
73223230
32883370
66373330
31826830
86632880
13336630
63133830
22832160
88263830
23226320
21362360
63268320
33317260
23666330
63133330
28363880
36267280
32633380
63233660
68266760
33731630
36662670
72688860
62223320
63362230
26766760
66236320
73332860
37223360
63333720
63373260
23728280
13336830
62233660
63626310
67323630
23333320
63333660
63376710
63623330
71623330
31866260
33623360
62636730
33283320
66661630
26622630
33333660
31823260
33268260
33662260
63266130
33233660
23323330
23382330
66123320
36136130
33682230
66387680
33863860
22222330
36628330
26363620
78323660
38723330
86321660
61236320
72237320
86233320
73162630
36883620
33633270
13332230
37332330
63333310
38636220
76676660
63337260
36633660
22266330
63216380
86336360
00000000
00000000
00000000
00000000
00000000
00000000
00000000
00000000
