00000000
00000000
00000000
00000000
15552650
22152550
56556560
52176160
22162720
55862850
15552670
15265660
26712660
67165660
65165550
55587660
75886150
61755560
56251550
77186610
61767650
66565560
82525660
66566680
56652550
55725250
52578820
55151250
56626860
55555650
26855260
57826260
27655510
51626550
25552560
25526150
67655160
28672520
76827560
76576520
61162650
52626650
25221560
56162560
66555560
15657150
65566520
58556850
56786260
66567260
55556550
72551550
85156650
85566180
12658150
51528520
62162250
25555750
56765560
26565620
55551750
76565250
15566750
56712660
56566150
51565150
56556660
55765650
58511560
65815650
56685570
66266160
21662780
65625650
56655160
56675570
51515720
26855560
51565150
52268220
15672850
65556880
52575550
78256570
76656520
56526650
27655860
61216650
52655260
85565660
62678650
25852550
86666660
55662610
55566660
55556560
55865150
62585510
66555520
66555760
25552620
55565560
62855860
65265550
00000000
00000000
00000000
00000000
00000000
00000000
00000000
00000000
