00000000
00000000
00000000
00000000
34433540
43353330
55544340
44433440
44424440
35443530
44354430
54134440
33342550
34332440
44455330
31435330
43455550
31543450
41334530
33444540
43353340
42354430
43553350
44333550
41333250
54454350
34333350
33443530
55435540
34333410
45444550
44154540
35333450
44444540
13323550
35432540
33353240
45453330
44353320
44444330
44535330
15435530
34434440
34454130
53323340
44133330
13552430
44434340
34453430
33533530
35333330
33544450
35335150
35344440
34245330
33354550
33344330
35453540
45333440
33553450
34545350
44353130
44454550
35335350
34455440
44534440
35534340
35543430
43343330
45553530
45355430
53554440
53455340
33553410
14433430
43445420
44345140
24554530
53343340
31455440
45333430
35451340
15533330
34443550
54335430
41554540
43354530
43553550
44313330
44354450
43253540
35445430
54434530
43345450
44413250
51553350
33414430
44325440
35454430
33344350
45424330
34453450
35335430
43354440
00000000
00000000
00000000
00000000
00000000
00000000
00000000
00000000
