00000000
00000000
00000000
00000000
43372870
27824340
36442850
58334440
44383320
66344430
68323450
35534260
44433620
74464430
37648540
75543530
55445540
54373360
83746630
37233830
58552340
68836750
36838360
74377540
75555360
45444470
54473840
55422430
83365530
34336560
73435480
53464750
43455230
52453360
34575340
75426330
45253570
42663230
47683860
73856330
23565780
86343340
32243330
33345720
43334840
86552360
44634340
33336270
33343470
45547330
35555650
35365340
63554330
56255760
23746630
33358330
33674640
44486630
73286850
45336530
47633340
55366470
76563360
85243630
23635840
43564450
62572350
36272680
84358430
73435640
85552650
58435480
36453470
46444350
43834830
44234340
36342630
34273440
75463360
35266340
45562430
38586830
36353640
36363580
44654670
63427820
35333330
34766360
44543470
65745540
77445660
56545560
82554350
63685650
82453440
34353650
46368660
58365330
34655330
33233550
36437580
77535340
45248850
45463350
00000000
00000000
00000000
00000000
00000000
00000000
00000000
00000000
