00000000
00000000
00000000
00000000
87778870
82828820
78272870
78287820
27788870
88787820
88778770
87878720
27877880
82822780
78882720
27822220
77788780
77782880
27272180
88887870
87772780
82777780
77777270
87777880
87788870
88888880
87781770
77878270
72288880
27788870
88178880
87128270
88881880
78872880
28277710
78887880
78872870
87277720
28772220
88787270
78711780
88727880
87877870
88282770
82777770
78888780
87712870
22887870
88817880
27722870
78827770
78877880
78827280
77777280
27787780
77787870
82887770
72288770
87888870
87778780
77278870
88728870
78888880
72778820
81788780
78882870
27288270
82778170
87278880
78817770
78882270
18787220
88272820
78877870
88287870
72788720
88827870
77112870
77288770
27888270
82727880
78772870
87878810
87788880
77887770
28787770
87781280
88878780
88127270
77877770
77788770
28872870
27788780
77772780
77881780
77822880
78877870
78288870
87872270
77778870
77887220
72782780
22788880
72827870
00000000
00000000
00000000
00000000
00000000
00000000
00000000
00000000
