00000000
00000000
00000000
00000000
42413350
55334530
44435330
33353350
35443550
54433340
33333440
34334340
33455340
45554330
34235450
43435340
54344430
54543430
45534340
43452550
45531430
33334430
43443310
34445430
53145430
33533530
55553350
35555550
35554440
35525330
44434450
55544440
34544350
34354440
51553330
44143330
53243440
33334410
35435530
35533350
53144340
55535350
55545510
34452340
54544340
54344450
45344450
35335440
34345430
34143350
45454450
14445330
35353540
23533440
44135340
33413550
53355340
33345450
34334350
44444540
34554410
34533120
35343430
43535450
51225550
33353150
54445250
45455340
35343530
22433430
34343330
31334350
33435430
33454530
45354430
33524530
53354430
43333350
43434540
33443440
45333530
35434440
23333540
44525440
35442330
34334130
55333340
34455350
55243440
54545530
32233440
54343420
44454440
34355330
34444340
43533430
35354450
11333330
34345430
53343530
31443550
33344440
34435340
45434330
00000000
00000000
00000000
00000000
00000000
00000000
00000000
00000000
