00000000
00000000
00000000
00000000
44546630
64635540
63235330
44464450
63455240
44446630
54653330
43422450
46663360
33355640
65636460
45365340
24453440
44336650
45336650
43656640
56463640
63263360
34363540
55644330
64553540
52644540
43455320
35664430
56556560
45634320
43356650
64336520
35535450
55546540
65445330
35455620
56355550
34566350
54444660
44466660
35333450
64524640
54466240
44664240
54334550
44345650
36633660
53366450
43654340
44443560
45456660
66433460
33564540
55555450
56244550
66645230
66643430
54366650
53554450
43654460
23356430
63535440
36665620
33434440
33346630
46436530
23546460
53326250
44633450
34664530
55354460
33465250
56536550
43366540
46543530
56653630
56452630
34336440
23553530
55663440
65524430
63634630
52625560
43355430
56633540
34335460
63635450
34323250
46633460
42454640
53636540
63552440
55354340
46335550
46344640
43434440
64464360
34563340
23254660
26663640
26626350
66544460
36456560
33454340
00000000
00000000
00000000
00000000
00000000
00000000
00000000
00000000
