00000000
00000000
00000000
00000000
56232350
41663550
23323360
23334320
55442450
14345340
54434630
15355440
54316330
34655230
53534330
35644340
66514360
56534340
33243560
32444630
41254520
13332630
63312310
56536450
53532320
63512450
25643510
15552640
45225330
41415330
45553640
33332440
55564440
24214420
45163530
66444340
51343630
43346330
45643360
34636460
34315130
55346340
54233460
63564340
36363460
36333540
35532430
15153540
12433540
42644330
52545410
23541630
11155310
35652320
45423440
31244550
66632130
64362240
35644560
12536530
51154140
33343360
55465360
24365550
43336340
36434360
66355340
52155350
34551530
52532250
33635330
43343530
45433150
65132440
12333530
36366630
65123460
35516340
22566550
13643610
23446360
53523360
62452330
63433140
55613320
45134430
64366630
44524440
33643660
34463130
41364360
44655330
31545360
54435150
43454560
54363360
54544430
33443530
35543340
35454410
14444550
45454450
55636430
53511450
00000000
00000000
00000000
00000000
00000000
00000000
00000000
00000000
