00000000
00000000
00000000
00000000
56665560
55552550
26558560
56558150
52656560
57616250
65561750
66562660
66526560
57256550
62582650
56157660
16588880
28651850
61658150
86276520
62256180
65567650
76851610
22555160
56215550
21152560
56552720
28566150
22255220
67675750
58666660
56652570
55526560
58226580
65525550
55515660
58526560
57668580
65861570
85725260
51666550
56277260
72626610
25265550
58576550
11551660
15852850
58822850
52566670
62265160
56528880
62652770
66716510
26255860
58555750
82555550
66165550
18552160
86261550
58616560
25565660
65265550
66557250
65168550
66558520
65256550
15685260
65622120
85766110
55765620
66667850
76666670
55665560
57528570
55765660
25552550
56258560
25555550
28156610
56566220
58565820
56577250
68756550
67128270
55666680
62266560
16265550
15575250
15521560
55655850
76556710
56772580
65227760
62628660
55266220
55165250
75265550
55251650
68556670
65555550
56255560
15851560
65157650
81667220
00000000
00000000
00000000
00000000
00000000
00000000
00000000
00000000
