00000000
00000000
00000000
00000000
55654450
35524130
35243440
34563510
65643210
54314430
35344460
53442460
36355330
56242450
33533610
46323650
33364460
46363630
24146220
63365630
56466330
26566560
32336330
53465350
33321640
34643340
33346350
54431230
25516340
35534460
65653640
15355440
15333130
65364630
41244420
43563450
13426450
15663540
43526220
14633540
44363620
66413330
34644310
56534330
33435340
54654550
56253660
44435250
43363440
55545340
66453660
61333630
33534630
34311360
44452310
45663550
34635360
42641410
45323630
35665230
53642620
33321540
66444340
62556340
15234330
56665230
35525340
54366440
54453350
34443350
63563350
43446330
45454340
44641430
63526530
43623440
65363340
21553330
45513640
53336640
53533360
66464340
64336440
44335540
46525360
62235340
14245340
35635530
52563330
44541440
13345330
31354540
64515540
54266540
55614450
53643450
15445410
42233530
64435450
34114510
64141620
24553620
63533530
61464350
00000000
00000000
00000000
00000000
00000000
00000000
00000000
00000000
