00000000
00000000
00000000
00000000
78878810
87727870
82888270
87882780
27888870
72772780
27282880
88172770
77722720
81787780
88887770
27778870
82228880
88878820
87782220
88777880
77282870
87222280
88782880
81278170
12727820
28727720
77287870
77788870
82888780
88728270
72778280
87827770
88877870
27872780
87788770
72888880
88787880
78277870
72787770
27288770
71887780
82888280
88877720
71717880
77877820
88887770
88882780
78817820
78717880
78277880
78287270
77877880
77828870
27878880
77777770
27822810
88887880
78771280
77827810
77778880
77278770
78788270
28288280
78787780
72288880
28878810
88788780
78787270
78887880
77877770
87278870
87778270
78888770
88728880
72272170
87777770
87887780
12828710
78787870
11778270
28877880
78187180
78772880
77828820
82877220
82878720
87827870
82827780
88888780
88888720
87888820
87882870
77778770
88878170
72887870
28787770
77887880
22727780
78777780
72122280
88887720
77777870
87288720
28278780
00000000
00000000
00000000
00000000
00000000
00000000
00000000
00000000
