00000000
00000000
00000000
00000000
51454450
54544450
44444540
55541450
44555440
45545540
54155150
44455540
45551440
55545540
44451140
44454440
14454540
41554440
51554540
51454450
44555410
45554510
55414140
54444440
44555440
44145550
44455550
45445140
45554440
45445550
54444540
55415440
14454540
45154450
44445440
44544540
54451140
44545440
51414540
45454450
44144450
55555540
44445510
45455440
55545540
15445450
45444410
44455440
45454440
51441550
44454440
44444140
54415440
44544540
44444550
44445540
44444450
44444510
41455440
44545540
45451440
55545540
55545450
44444440
54444410
41444440
54545540
14451540
45445410
51145140
14444550
15545440
44544440
54444550
54154450
44545140
55445110
14544550
45544440
54444540
55554440
45555540
44451450
44154540
55545450
45555440
45541510
54444440
55154140
55444450
11455550
45544150
44411450
45455440
54444550
45454450
44415540
55555440
45144440
45155450
55554550
45445440
44454450
45444550
00000000
00000000
00000000
00000000
00000000
00000000
00000000
00000000
