00000000
00000000
00000000
00000000
17877880
87177770
77881170
78788880
88887780
87778780
88888770
87788880
88887780
87888870
87887870
78877170
77878870
78888880
87888880
78878810
77887770
78778770
88777880
17777880
81887870
17787880
18711770
88888880
78781870
77188870
88771780
78781770
77878880
87188780
81888870
88788710
87818770
87887880
78778770
87887780
88777870
77777770
87188870
87878880
87788870
88788770
77888770
87787880
77777780
88877780
87788870
78871770
17877880
78878880
87778710
88887770
78787880
77887870
77888870
78181870
88778780
88817880
87788810
87778770
88818870
77778770
88787710
78787770
18717780
87778780
87178780
77787870
87788880
78877880
77788870
77888770
87888880
87878810
78888770
77888870
88787870
88877870
78788780
78178780
88787770
78717880
78778870
78877770
88888780
81777870
88777770
87888780
78817880
77887780
87777870
88788780
87887770
88877770
18877770
78887780
77877780
88877180
88888780
77188880
00000000
00000000
00000000
00000000
00000000
00000000
00000000
00000000
