00000000
00000000
00000000
00000000
55455510
45555450
45444440
45555550
55544450
15444410
44455540
55415550
45454440
45544540
45144450
45555450
45545540
54445440
45414440
54514450
44454540
44444450
55441450
54454550
54544540
54455510
41455510
54455540
44545440
54544440
55444410
55454440
45554550
44545550
44515550
54544540
15544540
45554440
44445440
14555410
44444440
54145540
41445450
44545440
45445540
55544550
54444550
44154440
15544440
55144440
41555440
44545450
44144440
44444150
45555440
55144440
14454550
45454450
44454450
44555440
51515540
55555450
44555540
44155450
45445450
55145550
55551440
55444550
55444440
55455510
44445440
54444440
54544540
45455550
45455550
44444450
44515540
45541540
41444540
14541550
45545410
44155440
44555540
54145550
44444540
14544510
44445540
44544440
54444440
54445440
44454140
44514140
54555540
15415550
45444540
55444450
44555550
54444440
44545540
55554440
54145450
44415550
45144440
14544450
00000000
00000000
00000000
00000000
00000000
00000000
00000000
00000000
