00000000
00000000
00000000
00000000
43244560
56653320
33665540
33546660
53345620
65335250
56542330
24436650
23443460
65545450
66246340
34446530
55555640
66454440
36465660
44463530
53263460
33444330
63454440
25456530
65533340
63444630
42455530
54633440
43366650
35323350
53553630
34556550
23646540
45666460
35544340
34534320
66643340
43654350
32655460
56365550
55464530
34345320
53344550
56644650
64642550
46354520
56234430
65356660
42443550
65335630
55435340
34354360
34354340
64554640
66663640
63255460
55336550
36255530
36263330
43356650
33533640
66666560
44455360
32334640
33534530
43363660
33542440
25654660
65663450
33533340
45545660
54463650
45464360
44362350
53464450
44463640
44456240
44443440
35655660
55344260
63556630
26635260
63655530
55655640
53552540
53626550
56523630
65633320
66566550
66443650
63556630
45563650
35534330
44256650
46466340
66344450
45325340
65525640
53525540
43455430
44332440
53636460
36552550
63636430
00000000
00000000
00000000
00000000
00000000
00000000
00000000
00000000
