00000000
00000000
00000000
00000000
21623330
63317230
36233330
26682630
32733320
37638380
82236730
66233370
63683630
18236230
28662620
62676630
67663330
36323730
83626630
26332370
26733170
32263330
37826630
72766660
23263680
67767630
76333280
67336820
73668320
68333730
22362260
32316610
26638370
73633360
66236830
86237620
36323760
33322260
71283620
66683230
63663670
26621380
67266830
67663620
66723830
63638630
36327280
76266160
36673320
23323330
88883260
37666330
36376310
37668360
68263320
23636160
63226260
83336610
21637630
23627370
32132360
22666620
33331330
67386280
72336630
63333660
88667660
36263780
63762230
32763160
62336660
33633320
62333360
22633620
32766680
62762330
38662330
37123880
13223820
33236620
12673360
23237760
66283130
23233330
66132830
26287760
37737310
13633860
72337660
23636260
31622680
36166630
32332680
33336260
88336280
87636380
22663360
22266620
23363320
17628630
36263330
36633320
36628220
33333210
00000000
00000000
00000000
00000000
00000000
00000000
00000000
00000000
