00000000
00000000
00000000
00000000
88423350
86644460
48353660
75445530
43433270
83664440
66352450
83525350
55358440
62634430
35348630
26354450
43323340
24685560
23455650
53583330
53363540
43563740
74336720
32356440
53543720
63433380
27363330
54753580
58766420
57675360
37753540
23553730
86338230
44653660
44366480
34754420
34436280
37334430
87883360
35558340
37345740
75284530
55754420
47332340
64537650
57553430
48456460
33328860
84746380
34545680
25764340
54333540
36444340
34672540
46244440
24384460
82353560
38365840
56433580
63355340
55447530
76365660
35385440
35334740
58254250
63435360
34522350
54553330
33536720
63334670
42454380
43884430
87275330
44676440
53344640
63666430
34646570
32445680
75733430
55583520
35656230
44345350
44883350
58453470
33774340
46534580
33648550
33846240
28453340
26545650
25338430
23343330
33446830
65344860
46443550
63357540
64536530
35344740
86385340
33544630
63346320
34333330
34734370
33453530
00000000
00000000
00000000
00000000
00000000
00000000
00000000
00000000
