00000000
00000000
00000000
00000000
77777880
88777870
78787880
88878780
77788780
78778870
88177810
81878780
78887870
18787880
78778880
78777770
78788770
87787780
88877780
71788870
78877710
77787870
77887180
78781880
87771780
17877880
77787770
88887880
78787770
78787780
78877170
78887770
78777780
88771870
81818880
88788870
87887870
87878880
77877870
77881780
87777870
87788870
78188770
78887870
77877870
78878870
77778780
77777780
17787810
88888880
87787870
78788870
77177770
78877880
87878780
78887870
88778870
88781870
17177780
87777880
81718780
87871780
78788170
17788780
87871170
77888870
78788870
77887780
88878770
88877770
78187780
88877780
77888870
78787780
78777770
87777780
17781870
87887870
78877710
77888780
88877870
78877780
77777770
88888870
77887870
88787770
88887780
87778770
78887770
88718770
81188880
77787780
78888770
71788880
78878780
88188880
77181880
81878780
78878880
88878880
87878870
77887880
78777870
81777880
00000000
00000000
00000000
00000000
00000000
00000000
00000000
00000000
